R 500 500
NO             ./pics/bluestone.png

SO           ./pics/fadedredbrick.png

WE           ./pics/yellowbrick.png

EA            ./pics/redbrick.png






S                   ./pics/barrel.png
F 90,60,40
C 170,100,70

11111111111111111111111111111
10000000001100S00000000000001
10111000011100000222000010001
10001000000000000000000010001
10111000011100200000000010001
10000000001111111111011110001
1121000121111    100000010001
1121000111111    101010010001
1100000011011    100000010001
10000000000011111100000010001
10002000022200001101010010001
11000000110101000000011110001
11210111100101011000011010001
11111111111111111111111111111






