NO ./pics/greystone.png
EA ./pics/purplestone.png
S ./pics/greenlight.png
F 70,30,40
C 80,100,60
SO ./pics/colorstone.png
WE ./pics/yellowbrick.png
R 600 380

11111111111111111111111111111
10000000001100000000000000001
10111001111100000222000010001
10100000210000001100000010001
100020000000W0001101010010001
11000000110101011111011110201
11110111111101000111000010001
11111111111111111111111111111
