SO ./pics/greystone.png
WE ./pics/yellowbrick.png
NO ./pics/greystone.png

EA ./pics/fadedredbrick.png
S ./pics/greystone.png
F 70,30,40
C 80,100,60

R 800 380

11111111111111111111111111111
10000000001100000000000000001
10111001111102222220000010001
10100000010000001100000010001
100000020000N0001101010010001
11000000110101011111011110001
11110111111101000111000010001
11111111111111111111111111111
