R 1920 1080
NO ./pics/greystone.png
SO ./pics/fadedredbrick.png
WE ./pics/yellowbrick.png
EA ./pics/m os  s   y.png

S ./pics/barrel.png
F 80,140,143
C 200,160,170

11111111111111111111111111111
10000000001100W00000000000001
11110000011100000222000010001
10010000000000000000000010001
11110000011100200000000010001
10000000001100000111011110001
11110111111111011100000010001
11110111111111011101010010001
11000000110121011100000010001
10000000000000001100000010001
10002000000000001101010010001
11000000110101011111011110001
11110111111101011111011110001
11111111111111111111111111111



